20
15
08,08,08,08,08,08,08,08,08,08,08,08,08,08,08,08,08,08,08,08
08,08,08,08,08,08,08,08,08,08,08,08,08,08,08,08,08,08,08,08
08,08,08,08,08,08,08,08,08,08,08,08,08,08,08,08,08,08,08,08
08,08,08,08,08,08,08,08,08,08,08,08,08,08,08,08,08,08,08,08
08,08,08,08,08,08,08,08,08,08,08,08,08,08,08,08,08,08,08,08
08,08,08,08,08,08,08,08,08,08,08,08,08,08,08,08,08,08,08,08
08,08,08,08,08,08,08,08,08,08,08,08,08,08,08,08,08,08,08,08
08,08,08,08,08,08,08,08,08,08,08,08,08,08,08,08,08,08,08,08
08,08,08,08,08,08,08,08,08,08,08,08,08,08,08,08,08,08,08,08
08,08,08,08,08,08,08,08,08,08,08,08,08,08,08,08,08,08,08,08
16,16,16,08,08,08,08,08,08,08,08,08,08,08,08,08,08,08,08,08
16,16,16,08,08,08,08,08,08,08,08,08,08,08,08,08,08,08,08,08
16,08,08,08,08,08,08,08,08,08,08,08,08,16,16,08,08,08,08,08
16,08,08,08,08,08,16,16,16,08,08,08,08,27,27,08,08,08,16,16
16,16,16,16,16,16,16,16,16,16,16,16,16,27,27,08,08,08,16,16